@@@@@@@@@@@@@@@@@@@@@@@@@@@@TT........................................................................T@@@@@@@@@@@@@@@@@@@@@@@@@@@@@@@@@@@@@@@@@@@@@@@@@@@@@@@@@@
@@@@@@@@@@@@@@@@@@@@@@@@@@@@@@T........................................................................T@@@@@@@@@@@@@@@@@@@@@@@@@@@@@@@@@@@@@@@@@@@@@@@@@@@@@@@@@@
@@@@@@@@@@@@@@@@@@@@@@@@@@@@@@T........TT..............TT......TT......................................T@@@@@@@@@@@@@@@@@@@@@@@@@@@@@@@@@@@@@@@@@@@@@@@@@@@@@@@@@@
@@@@@@@@@@@@@@@@@@@@@@@@@@@@@@@TTTTTTTT@@TTTTTTT.......TT......TT.....TTTTTTTTTTTTTTTTTTTTTTTTTT.......T@@@@@@@@@@@@@@@@@@@@@@@@@@@@@@@@@@@@@@@@@@@@@@@@@@@@@@@@@@
@@@@@@@@@@@@@@@@@@@@@@@@@@@@@@@@@@@@@@@@@@@@@@@@TT.....T@T.....T@T....T@@@@@@@@@@@@@@@@@@@@@@@@@TTTTTTT@@@@@@@@@@@@@@@@@@@@@@@@@@@@@@@@@@@@@@@@@@@@@@@@@@@@@@@@@@@
@@@@@@@@@@@@@@@@@@@@@@@@@TTTTTTT@@@@@@@@@@@@@@@@@T.....T@T.....T@T....T@@@@@@@@@@@@@@@@@@@@@@@@@@TTTTTT@@@@@@@@@@@@@@@@@@@@@@@@@@@@@@@@@@@@@@@@@@@@@@@@@@@@@@@@@@@
@@@@@@@@@@@@@@@@@@@@@@@@T.......TTTTTTTTTTTTTTTTTT.....TTT.....TTT....TTTTTTTTTTTTTTTTTTTTTTTTTTT......T@@@@@@@@@@@@@@@@@@@@@@@@@@@@@@@@@@@@@@@@@@@@@@@@@@@@@@@@@@
@@@@@@@@@@@@@@@@@@@@@@@@T..............................................................................T@@@@@@@@@@@@@@@@@@@@@@@@@@@@@@@@@@@@@@@@@@@@@@@@@@@@@@@@@@
@@@@@@@@@@@@@@@@@@@@@@@@T..............................................................................T@@@@@@@@@@@@@@@@@@@@@@@@@@@@@@@@@@@@@@@@@@@@@@@@@@@@@@@@@@
@@@@@@@@@@@@@@@@@@@@@@@@T..............................................................................T@@@@@@@@@@@@@@@@@@@@@@@@@@@@@@@@@@@@@@@@@@@@@@@@@@@@@@@@@@
@@@@@@@@@@@@@@@@@@@@@@@@T..............................................................................T@@@@@@@@@@@@@@@@@@@@@@@@@@@@@@@@@@@@@@@@@@@@@@@@@@@@@@@@@@
@@@@@@@@@@@@@@@@@@@@@@@@T..............................................................................T@@@@@@@@@@@@@@@@@@@@@@@@@@@@@@@@@@@@@@@@@@@@@@@@@@@@@@@@@@
@@@@@@@@@@@@@@@@@@@@@@@@@T.....................TTTTTTTTTTTTTTTTTTTTTTTTTTTTTTTTTTTTTTTTTTTTTTTTTT......T@@@@@@@@@@@@@@@@@@@@@@@@@@@@@@@@@@@@@@@@@@@@@@@@@@@@@@@@@@
@@@@@@@@@@@@@@@@@@@@@@@@@T.....................T@@@@@@@@@@@@@@@@@@@@@@@@@@@@@@@@@@@@@@@@@@@@@@@@T.....T@@@@@@@@@@@@@@@@@@@@@@@@@@@@@@@@@@@@@@@@@@@@@@@@@@@@@@@@@@@
@@@@@@@@@@@@@@@@@@@@@@@@@T.....................T@@TTTTTTTTTTTTTTTTTTTTTTTTT@@@@@@@@@@@@@@@@@@@@@T....T@@@@@@@@@@@@@@@@@@@@@@@@@@@@@@@@@@@@@@@@@@@@@@@@@@@@@@@@@@@@
@@@@@@@@@@@@@@@@@@@@@@@@@T.....................T@T.........................TTTTTTTTTTTTTTTTTTTT@T....T@@@@@@@@@@@@@@@@@@@@@@@@@@@@@@@@@@@@@@@@@@@@@@@@@@@@@@@@@@@@
@@@@@@@@@@@@@@@@@@@@@@@@@T.....................T@T.............................................TT....T@@@@@@@@@@@@@@@@@@@@@@@@@@@@@@@@@@@@@@@@@@@@@@@@@@@@@@@@@@@@
@@@@@@@@@@@@@@@@@@@@@@@@@T.....................T@T.............................................TT....T@@@@@@@@@@@@@@@@@@@@@@@@@@@@@@@@@@@@@@@@@@@@@@@@@@@@@@@@@@@@
@@@@@@@@@@@@@@@@@@@@@@@@@T.........TTTTTTTTTT..T@T.............................................TT....T@@@@@@@@@@@@@@@@@@@@@@@@@@@@@@@@@@@@@@@@@@@@@@@@@@@@@@@@@@@@
@@@@@@@@@@@@@@@@@@@@@@@@@T.........TTTTTTTTTT..T@T.............................................TT....T@@@@@@@@@@@@@@@@@@@@@@@@@@@@@@@@@@@@@@@@@@@@@@@@@@@@@@@@@@@@
@@@@@@@@@@@@@@@@@@@@@@@@@T.....................T@T.............................................TT.....T@@@@@@@@@@@@@@@@@@@@@@@@@@@@@@@@@@@@@@@@@@@@@@@@@@@@@@@@@@@
@@@@@@@@@@@@@@@@@@@@@@@@@T.....................T@T.............................................TT.....T@@@@@@@@@@@@@@@@@@@TTTTT@@@@@@@@@@@@@@@@@@@@@@@@@@@@@@@@@@@
@@@@@@@@@@@@@@@@@@@@@@@@@T.....................T@T.............................................TT.....T@@@@@@@@@@@@@@@@@@T.....TTTT@T@@@@@@@@@@@@@@@@@@@@@@@@@@@@@
@@@@@@@@@@@@@@@@@@@@@@@@@T.....................T@T....................................................T@@@@@@@@@@@@@@@@@@T.........T..@@@@@@@@@@@@@@@@@@@@@@@@@@@@
@@@@@@@@@@@@@@@@@@@@@@@@@T.........TTTTTTTTTT..T@T....................................................T@@@@@@@@@@@@@@@@@@T.............T@@@@@@@@@@@@@@@@@@@@@@@@@@
@@@@@@@@@@@@@@@@@@@@@@@@@T.........TTTTTTTTTT..T@T....................................................T@@@@@@@@@@@@@@@@@@T.............T@@@@@@@@@@@@@@@@@@@@@@@@@@
@@@@@@@@@@@@@@@@@@@@@@@@@T.....................T@T....................................................T@@@@@@@@@@@@@@@@@@T.............T@@@@@@@@@@@@@@@@@@@@@@@@@@
@@@@@@@@@@@@@@@@@@@@@@@@@T....TTTT............T@@T....TTTTTTTTTTTTTTTTTTTT.TT.TTTT....TTTT............T@@@@@@@@@@@@@@@@@@T.........TTTT@@@@@@@@@@@@@@@@@@@@@@@@@@@
@@@@@@@@@@@@@@@@@@@@@@@@@T....T@@@TTTTTTTTTTTT@@@T....T@@@@@@@@@@@@@@@@@@@T@T.T@@T....T@@T............T@@@@@@@@@@@@@@@@@@@TTT......T@@@@@@@@@@@@@@@@@@@@@@@@@@@@@@
@@@@@@@@@@@@@@@@@@@@@@@@@T....T@@@@@@@@@@@@@@@@@@T....T@@@@TTT@@@@T@@@@@@@@T..T@@T....T@@T............T@@@@@@@@@@@@@@@@@@@@@T......TTTTT@@@@@@@@@@@@@@@@@TTTTTT@@@
@@@@@@@@@@@@@@@@@@@@@@@@@T....T@@@@@@@@@@@TTTTT@@T....T@@@T...TTTT.T@@@@@@T...T@@T....T@@T............TTTTTT@@@@@@@@TTTTTTTTT...........TTTT@@@@@@@@@TTTT......T@@
@@@@@@@@@@@@@@@@@@@@@@@@@T.....T@@@@@@@@@T.....T@T....T@@T.........T@@@@@@T....TT......TT...................T@@@@@@T........................T@@@@@@@T..........T@@
@@@@@@@@@@@@@@@@@@@@@@@@@T.....T@@@@@@@@@T.....T@T....T@T..........TT@@@@@T.................................T@@@@@@T........................T@@@@@@@T..........T@@
@@@@@@@@@@@@@@@@@@@@@@@@@T.....T@@@@@@@@T......T@T....T@T............TT@@@T..................................T@@TTT..........................T@@@TTT...........T@@
@@@@@@@@@@@@@@@@@@@@@@@@@T.....T@@@@@@@@T......T@T....T@T..............T@@T...................................TT..............................TTT...........TTT@@@
@@@@@@@@@@@@@@@@@@@@@@@@@T.....T@@@@@@@@@T.....TT......TT..............T@@T.................................................................................TT@@@@
@@@@@@@@@@@@@@@@@@@@@@@@@T.....T@@@@@@@@@@TTT..TT......TT..............T@@T...................................................................................T@@@
@@@@@@@@@@@@@@@@@@@@@@@@@T.....T@@@@@@@@@@@@T..TT......TT..............T@@T...................................................................................T@@@
@@@@@@@@@@@@@@@@@@@@@@@@@T.....T@@@@@@@@@@@@T..........................T@@T...................................................................................T@@@
@@@@@@@@@@@@@@@@@@@@@@@@@T.....T@@@@@@@@@@@@T..........................T@T....................................................................................T@@@
@@@@@@@@@@@@@@@@@@@@@@@@@T.....T@@@@@@@@@@@@T..........................T@T....................................................................................T@@@
@@@@@@@@@@@@@@@@@@@@@@@@@T.....T@@@@@@@@@@@@@T.........................T@T....................................................................................T@@@
@@@@@@@@@@@@@@@@@@@@@@@@@T.....T@@@@@@@@@@@@TT.........................T@T....................................................................................T@@@
@@@@@@@@@@@@@@@@@@@@@@@@@T.....T@@@@@@@@@@@T...........................T@@TT..................................................................................T@@@
@@@@@@@@@@@@@@@@@@@@@@@@@T.....T@@@@@@@@@@@T...TT......TT...........TTT@@@@T..................................................................................T@@@
@@@@@@@@@@@@@@@@@@@@@@@@@T.....T@@@@@@@@@@@T...TT......TT...........T@@@@@T...................................................................................T@@@
@@@@@@@@@@@@@@@@@@@@@@@@@T.....T@@@@@@@@@@@T...TT......TT............TT@@@@T................................................................................TT@@@@
@@@@@@@@@@@@@@@@@@@@@@@@@T.....T@@@@@@@@@@TT...T@T....T@T..............T@@@T.................................TT..T............................TTTT..........TTT@@@
@@@@@@@@@@@@@@@@@@@@@@@@@T.....T@@@@@@@@@T.....T@T....T@T..........TTTT@@@@.................................T@@TT@T..........................T@@@@TT...........T@@
@@@@@@@@@@@@@@@@@@@@@@@@@T.....T@@@@@@@@@@T....T@T....T@T..........T@@@@@@@T................................T@@@@@T..........................T@@@@@T...........T@@
@@@@@@@@@@@@@@@@@@@@@@@@@T.....T@@@@@@@@@@T....T@T....T@@T.........T@@@@@@@@T..TT......TT...................T@@@@@@T.........................T@@@@@@T..........T@@
@@@@@@@@@@@@@@@@@@@@@@@@@T....T@@@@@@@@@@@@TTTT@@T....T@@@T...TTTT.T@@@@@@@@T.T@@T....T@@T............TTTTTT@@@@@@@@TTTT...........TTTTTTTTTT@@@@@@@@TTT.......T@@
@@@@@@@@@@@@@@@@@@@@@@@@@T....T@@@@@@@@@@@@@@@@@@T....T@@@@TTT@@@@T@@@@@@@@@T.T@@T....T@@T............T@@@@@@@@@@@@@@@@@TTTTT......T@@@@@@@@@@@@@@@@@@@@TTTTTTT@@@
@@@@@@@@@@@@@@@@@@@@@@@@@T....T@@@TTTTTTTTTTTT@@@T....T@@@@@@@@@@@@@@@@@@@@T..T@@T....T@@T............T@@@@@@@@@@@@@@@@@@@@@T......TTTTTTT@@@@T@@@@@@@@@@@@@@@@@@@
@@@@@@@@@@@@@@@@@@@@@@@@@T....TTTT............T@@T....TTTTTTTTTTTTTTTTTTTTT...TTTT....TTTT............T@@@@@@@@@@@@@@@@@@@TTT.............TTTT.T@@@@@@@@@@@@@@@@@@
@@@@@@@@@@@@@@@@@@@@@@@@@T.....................T@T....................................................T@@@@@@@@@@@@@@@@@@T.....................T@@@@@@@@@@@@@@@@@@
@@@@@@@@@@@@@@@@@@@@@@@@@T.........TTTTTTTTTT..T@T....................................................T@@@@@@@@@@@@@@@@@@T.....................T@@@@@@@@@@@@@@@@@@
@@@@@@@@@@@@@@@@@@@@@@@@@T.........TTTTTTTTTT..T@T....................................................T@@@@@@@@@@@@@@@@@@T.....................T@@@@@@@@@@@@@@@@@@
@@@@@@@@@@@@@@@@@@@@@@@@@T.....................T@T....................................................T@@@@@@@@@@@@@@@@@@T.TT..................T@@@@@@@@@@@@@@@@@@
@@@@@@@@@@@@@@@@@@@@@@@@@T.....................T@T.............................................TT.....T@@@@@@@@@@@@@@@@@@@@@T....TTT...TT.....T@@@@@@@@@@@@@@@@@@@
@@@@@@@@@@@@@@@@@@@@@@@@@T.....................T@T.............................................TT.....T@@@@@@@@@@@@@@@@@@@@@@TTTT@@@TTT@@TTTTT@@@@@@@@@@@@@@@@@@@@
@@@@@@@@@@@@@@@@@@@@@@@@@T.....................T@T.............................................TT.....T@@@@@@@@@@@@@@@@@@@@@@@@@@@@@@@@@@@@@@@@@@@@@@@@@@@@@@@@@@@
@@@@@@@@@@@@@@@@@@@@@@@@@T.........TTTTTTTTTT..T@T.............................................TT....T@@@@@@@@@@@@@@@@@@@@@@@@@@@@@@@@@@@@@@@@@@@@@@@@@@@@@@@@@@@@
@@@@@@@@@@@@@@@@@@@@@@@@@T.........TTTTTTTTTT..T@T.............................................TT....T@@@@@@@@@@@@@@@@@@@@@@@@@@@@@@@@@@@@@@@@@@@@@@@@@@@@@@@@@@@@
@@@@@@@@@@@@@@@@@@@@@@@@@T.....................T@T.............................................TT....T@@@@@@@@@@@@@@@@@@@@@@@@@@@@@@@@@@@@@@@@@@@@@@@@@@@@@@@@@@@@
@@@@@@@@@@@@@@@@@@@@@@@@@T.....................T@T.............................................TT....T@@@@@@@@@@@@@@@@@@@@@@@@@@@@@@@@@@@@@@@@@@@@@@@@@@@@@@@@@@@@
@@@@@@@@@@@@@@@@@@@@@@@@@T.....................T@T.........................TTTTTTTTTTTTTTTTTTTT@T....T@@@@@@@@@@@@@@@@@@@@@@@@@@@@@@@@@@@@@@@@@@@@@@@@@@@@@@@@@@@@
@@@@@@@@@@@@@@@@@@@@@@@@@T.....................T@@TTTTTTTTTTTTTTTTTTTTTTTTT@@@@@@@@@@@@@@@@@@@@@T....T@@@@@@@@@@@@@@@@@@@@@@@@@@@@@@@@@@@@@@@@@@@@@@@@@@@@@@@@@@@@
@@@@@@@@@@@@@@@@@@@@@@@@@T.....................T@@@@@@@@@@@@@@@@@@@@@@@@@@@@@@@@@@@@@@@@@@@@@@@@T.....T@@@@@@@@@@@@@@@@@@@@@@@@@@@@@@@@@@@@@@@@@@@@@@@@@@@@@@@@@@@
@@@@@@@@@@@@@@@@@@@@@@@@T......................TTTTTTTTTTTTTTTTTTTTTTTTTTTTTTTTTTTTTTTTTTTTTTTTTT.....T@@@@@@@@@@@@@@@@@@@@@@@@@@@@@@@@@@@@@@@@@@@@@@@@@@@@@@@@@@@
@@@@@@@@@@@@@@@@@@@@@@@@T..............................................................................T@@@@@@@@@@@@@@@@@@@@@@@@@@@@@@@@@@@@@@@@@@@@@@@@@@@@@@@@@@
@@@@@@@@@@@@@@@@@@@@@@@@T..............................................................................T@@@@@@@@@@@@@@@@@@@@@@@@@@@@@@@@@@@@@@@@@@@@@@@@@@@@@@@@@@
@@@@@@@@@@@@@@@@@@@@@@@@T..............................................................................T@@@@@@@@@@@@@@@@@@@@@@@@@@@@@@@@@@@@@@@@@@@@@@@@@@@@@@@@@@
@@@@@@@@@@@@@@@@@@@@@@@@T..............................................................................T@@@@@@@@@@@@@@@@@@@@@@@@@@@@@@@@@@@@@@@@@@@@@@@@@@@@@@@@@@
@@@@@@@@@@@@@@@@@@@@@@@@T..............................................................................T@@@@@@@@@@@@@@@@@@@@@@@@@@@@@@@@@@@@@@@@@@@@@@@@@@@@@@@@@@
@@@@@@@@@@@@@@@@@@@@@@@@T......TTTTTTTTTTTTTTTTT......................TTTTTTTTTTTTTTTTTTTTTTTTTT.......T@@@@@@@@@@@@@@@@@@@@@@@@@@@@@@@@@@@@@@@@@@@@@@@@@@@@@@@@@@
@@@@@@@@@@@@@@@@@@@@@@@@@TTTTTT@@@@@@@@@@@@@@@@@TT.....TTT.....TTT....T@@@@@@@@@@@@@@@@@@@@@@@@@TTTTTTT@@@@@@@@@@@@@@@@@@@@@@@@@@@@@@@@@@@@@@@@@@@@@@@@@@@@@@@@@@@
@@@@@@@@@@@@@@@@@@@@@@@@@@@@@@@@@@@@@@@@@@@@@@@@@T.....T@T.....T@T....T@@@@@@@@@@@@@@@@@@@@@@@@@@TTTTTT@@@@@@@@@@@@@@@@@@@@@@@@@@@@@@@@@@@@@@@@@@@@@@@@@@@@@@@@@@@
@@@@@@@@@@@@@@@@@@@@@@@@@@@TTTTTTTTTTTT@@TTTTTTTTT.....T@T.....T@T....TTTTTTTTTTTTTTTTTTTTTTTTTTT......T@@@@@@@@@@@@@@@@@@@@@@@@@@@@@@@@@@@@@@@@@@@@@@@@@@@@@@@@@@
@@@@@@@@@@@@@@@@@@@@@@@@@@T............TT..............TT......TT......................................T@@@@@@@@@@@@@@@@@@@@@@@@@@@@@@@@@@@@@@@@@@@@@@@@@@@@@@@@@@
@@@@@@@@@@@@@@@@@@@@@@@@@@T............................................................................T@@@@@@@@@@@@@@@@@@@@@@@@@@@@@@@@@@@@@@@@@@@@@@@@@@@@@@@@@@
@@@@@@@@@@@@@@@@@@@@@@@@@@T.........................................................................TTT@@@@@@@@@@@@@@@@@@@@@@@@@@@@@@@@@@@@@@@@@@@@@@@@@@@@@@@@@@@